8 8
########
#......#
#....A.#
#......#
#..1.a.#
#......#
#@.....#
########